#############################################################
#   # #     # #     #           #   # #       # # # #   #   #
#   # # ##### # # # ##### ####### # # ##### ### # # # ### ###
#               # # #           # #   #         #   #   #   #
### # ######### ############# ##### # ####### ### # ### ### #
#     #             #   # #     #   # #           #         #
##### # ### # # ### # ### ##### # ### ############### ### ###
# #   # #   # #   # #               #                   #   #
# # ### ### ##### # ################### ################### #
# # # # #   #     # # # # # #   #                     # # # #
# # # # ########### # # # # # ### ####### # # # ##### # # # #
# #   # #                 # #           # # # #     #   # # #
# # ### ####### ####### # # # # # ####### # # ######### # # #
#       #           #   #     # #       # # # #         #   #
########### ##################### ##################### # # #
#           #         # # # # #   #           # #     # # # #
########### # ### ##### # # # # # # # ######### # # # # # # #
#   #   #     #   #         # # #   # #         # # #   # # #
# ### # # # # # ### # # # # # # # # # # ### ### # # # # # # #
#     #   # # #     # # # #     # # #   #     #   # # # # # #
#############################################################